1111111111111111111111111111111111111111111111
1E1000000000000C00000C000000000000000001000001
1010010100100000101001000000010100000001111111
1010010010101010001001000000010101000000000001
1P0000000C00C0000000000000000000C1000000000001
100000000000000000000CC00000000111111110000001
1111111000000000111111011111111111011111000001
1C00000000111111111110000000001111111100000001
1000000000000111111111000000000000000000000001
1111111100000000000000000000C000000C0000000001
11C0000000000000000000000000000000000000000001
1000000000000000000000000000001111111111111111
1000000000000000C00000000000000000000010000001
1000000000000111110000000000111100011100000001
1CCCCC0000000000000000000000000000010100000001
1000000000000001111111111111100000011100000001
1000000110000000000000000000110000000000011001
1000000000000000C00000000C00000000110000000001
11100000000001100000000000000111110000000000C1
1111111111111111111111111111111111111111111111
