				
				
				
				11111111111111111111111111111
				1P000C000C000C000C000C000C0E1
				100C000C000C000C000C000C000C1
				1C000C000C000C000C000C000C001
				100C000C000C000C000C000C000C1
				1C000C000C000C000C000C000C001
				100C000C000C000C000C000C000C1
				1C000C000C000C000C000C000C001
				100C000C000C000C000C000C000C1
				1C000C000C000C000C000C000C001
				11111111111111111111111111111