


NO ./textures/no_wall.xpm
SO	./textures/so_wall.xpm
 EA  ./textures/ea_wall.xpm
	WE		./textures/we_wall.xpm

C	255, 255,5	
F 125,125,0 

        1111111111111111111111111
        1000000000110000000000001
        1011000001110000000000001
        1001000000000000000000001
111111111011000001110000000000001
100000000011000001110111111111111
11110111111111011100000010001
11110111111111111111011110001
11111111111111111111111111111
11111111111111111111111111111
11000000110101011100000010001
10000000000000001100000010 01
10000000000000001101010010001
1100000110101011111011110N0111
11110111 1110101 101111010001
11111111 1111111 111111111111
