NO ./textures/no_wall.xpm
SO ./textures/so_wall.xpm
WE ./textures/we_wall.xpm
EA ./textures/ea_wall.xpm
F 0,100,100
C 100,0,100

11111111111
10000000001
10 00W00 01
10000000001
11111111111